....................
....................
....................
.....R..............
....###.........R...
..............######
........####........
....................
....................
.....R....###.......
...#######..........
...............###..
....................
.1...R..........R..R
####################
